111111111111111111111
10001110000C000000E01
100000000000011111001
100010000000000111111
10C000001110000P00001
10001100000C000001001
111111111111111111111