1111111
1001E01
1C0P001
100C1011
1111111