1111111111111111
1000E01000000011
100000000000C001
1000001110010000
11111000100P0001
1111111111111111