1111111111111
1000000001111
1100E00001111
110000C001111
1000P00001C11
1111111111111