111111111
1000010E1
100C01001
1P0000101
111111111