11111111
10000001
100E0001
1000C001
10000001
11111111